4444444444444444444444444444444444444444444444444444444444444444444444444444444444444444
4111111111111111112221111122111221111111221111111111122111221111112221111111111111111114
4100000000000000000000000000000000000000000000000000000000000000000000000000000001000314
4100000000000000000000000000000000000000000000000000000000000000000000000000000001003314
4100000000000000000000000000000000000000000000000000000000000000000000000000000031000314
4100000000000000000000000000000000000000000000000000000000000000000000000000130031003314
4100000000000000000000000000000000000000000000000000000000000000000000001000111111000314
4100000000000000000000000000000000000000000000000000000000000000000000001000130000003314
4200000000000000000000000000000000000000000000000000000000000000000000001000100300000314
4200000000000000000000000000000000000000000000000000000000000000000000001000133300003314
4200000000000000000000000000000000000000000000000000000000000000000000001000100000000014
4100000000000000000000000000000000000000000000000000000000000000000000001000000000000014
4100000000000000000000000000000000000000000000000000000000000000000000001000000333033314
4100000000000000000000000000000000000000000000000000000000000000000000001000111111111114
4100000000000000000000000000000000000000000000000000000000000000000000001000000333033314
4100000000000000000000000000000000000000000000000000000000000000000000001000000000000014
4100000000000000000000000000000000000000000000000000000000000000000000001000133300000014
4200000000000000000000000000000000000000000000000000000000000000000000001000100300000014
4200000000000000000000000000000000000000000000000000000000000000000000001000130000000014
4200000000000000000000000000000000000000000000000000000000000000000000001000133300000014
4200000000000000000000000000000000000000000000000000000000000000000000001000100300000014
4100000000000000000000000000000000000000000000000000000000000000000000001000130000000014
4100000000000000000000000000000000000000000000000000000000000000000000000000133300000014
4100000000000000000000000000000000000000000000000000000000000000000000000000100300000014
4100000000000000000000000000000000000000000000000000000000000000000000000000130000000014
4100000000000000000000000000000000000000000000000000000000000000000000000000111111111114
4200000000000000000000000000000000000000000000000000000000000000000000000000000000000014
4200000000000000000000000000000000000000000000000000000000000000000000000000000000000014
4200000000000000000000000000000000000000000000000000000000000000000000000000000000000014
4100000000000000000000000000000000000000000000000000000000000000000000000000000000000014
4100000000000000000000000000000000000000000000000000000000000000000000000000000000000014
4100000000000000000000000000000000000000000000000000000000000000000000000000000000000024
4100000000000000000000000000000000000000000000000000000000000000000000000000000000000024
4100000000000000000000000000000000000000000000000000000000000000000000000000000000000024
4100000000001000000000000000000000000000000000000000000000000000000000000000000000000024
4100000000001000000000000000000000000000000000000000000000000000000000000000000000000024
4100000000001000000000000000000000000000000000000000000000000000000000000000000000000014
4100000000001000000000000000000000000000000000000000000000000000000000000000000000000014
4100000000001000000000000000000000000000000000000000000000000000000000000000000000000014
4100000000001000000000000000000000000000000000000000000000000000000000000000000000000014
4200000000001000000000000000000000000000000000000000000000000000000000000000000000100014
4200000000001000000000000000000000000000000000000000000000000000000000000000000000100014
4200000000001000000000000000000000000000000000000000000000000000000000000000000000100014
4200000000001000000000000000000000000000000000000000000000000000000000000000000000100014
4200000000001000000000000000000000000000000000000000000000000000000000000000000000100014
4100000000001000000000000000000000000000000000000000000000000000000000000000000000100024
4100000000001000000000000000000000000000000000000000000000000000000000000000000000100024
4100000000001000000000000000000000000000000000000000000000000000000000000000000000100024
4100000000001000000000000000000000000000000000000000000000000000000000000000111111100014
4100000000001000000000000000000000000000000000000000000000000000000000000000100000000014
4100000000001000000000000000000000000000000000000000000000000000000000000000100000000014
4100000000000000000000000000000000000000000000000000000000000000000000000000100000000014
4100000000000000000000000000000000000000000000000000000000000000000000000000100000000014
4100000000000000000000000000000000000000000000000000000000000000000000000000100011111114
4100000000000000000000000000000000000000000000000000000000000000000000000000100000000014
4100000000000000000000000000000000000000000000000000000000000000000000000000100000000014
4200000000000000000000000000000000000000000000000000000000000000000000000000100013303014
4200000000000000000000000000000000000000000000000000000000000000000000000000111111111114
4200000000000000000000000000000000000000000000000000000000000000000000000000100000000014
4100000000000000000000000000000000000000000000000000000000000000000000000000100000000014
4100000000000000000000000000000000000000000000000000000000000000000000000000100013303014
4100000000000000000000000000000000000000000000000000000000000000000000000000100011111114
4100000000000000000000000000000000000000000000000000000000000000000000000000100013303014
4100000000000000000000000000000000000000000000000000000000000000000000000000100000000014
4100000000000000000000000000000000000000000000000000000000000000000000000000100000000014
4100000000000000000000000000000000000000000000000000000000111111111111111111100011111114
4200000000000000000000000000000000000000000000000000000000100000000000000000000033333314
4200000000000000000111111111111111111111111111111111100000100000000000000000000000000014
4200000000000000000100000000000000000000010000000100000000100000000000000000000000000024
4100000000000000000100000000000000000000010000000100000000100000000000000000000000000024
4100000000000000000100000000000000000000000000000000011111100000000000000000000000000024
4100000000000000000100000000000000000000000000000000000000000000000000000000000000000314
4100000000000000000100000000000000000000000000000000000000000000000000000000000000000314
4100000000000000000100000000000000000000000000000000000000000000000000000000000000000314
4100000000000000000133333333333333333333333333333300000000000000033333333333333333333314
4111111111111222111111111111111111111111111111111111111122211111111111111111111111111114
4444444444444444444444444444444444444444444444444444444444444444444444444444444444444444