444444444444444444444444444444444444444444444444444444444444444444444444444444444444444444444
444444444411111111111111114444444444444444444444444411111111111111114444444444444444444444444
444444444410000001000000014444444444444444444444444410000001000000014444444444444444444444444
444411111110000001000000011111111111111111111111111110000001000000014444444444444444444444444
444410000000000001000000000010000100001000010000100000000001000000011114444444444444444444444
444410000000000001000000000010000100001000010000100000000001000000000014444444444444444444444
444410000000000001000000000010000100001000010000100000000001000000000014444444444444444444444
444410000000000001000000000010000100001000010000100000000001000000000014444444444444444444444
444410000000000001000000000010000100001000010000100000000001000000000014444444444444444444444
444410000000000001000000000010000100001000010000100000000001000000000014444444444444444444444
444410000000000001000000000010000100001000010000100000000001000000000011111111111114444444444
444410000000000001000000000010000100001000010000100000000001000000000010000000000111444444444
444410000000000001000000000010000100001000010000100000000001000000000010000000000001144444444
444410000000000001000000000010000100001000010000100000000001000000000010000000000000144444444
411110000000000001000000000010000100001000010000100000000001000000000010000000000000114444444
410010000000000001000000000010000100001000010000100000000001000000000010000000000000114444444
410011001111110011100111100111001110011100111001110011110011100111100110000000000001114444444
410000000000000000000000000000000000000000000000000000000000000000000010000000000011011444444
410000000000000000000000000000000000000000000000000000000000000000000011000000000110001144444
410000000000000000000000000000000000000000000000000000000000000000000001000000001100000114444
410000000000000000000000000000000000000000000000000000000000000000000000000000011000000011444
410000000000000000000000000000000000000000000011100001111111111000000000000100110000000001144
410000111111111000111000011111000011000000000010000000000000001100000000000111100000000000114
410000100010001000100000000000000001000000000010000000000000000110000000000011000000000000014
410000100010001000100000000000000001000000000010000000000000000000000000000001100000000000014
410000100010001000100000000000000001000000000010000000000000000000000000000000100000000000014
410000100010001000100000000001111111000000000010000000000000000000010000000000000000000000014
410000100111001111100000000001444420000000000010000000000000000000011000000000000000000000014
410000000000000000000000000001444420000000000010000000000000000000001100000000000000000000114
410000000000000000000000000001444420000000000011111110000000000000000100000000000110000001144
411100111111001111100000000001441110000000000010010010000000000000000100000000000011000011444
410000000000000144100000000001444410000011111110010011111110011111111100000000000001100114444
410000000000000144100000000001444410000010000000000000000000000000000000000000000000111144444
411111000000000144100000000001444410000010000000000000000000000000000000000000000000244444444
444441000000000144100000000001444410000010000000000000000000000000000000000000000000244444444
444441000000000144100000000001444410000000000000000000000000000000000000000000000000244444444
444441000000000144100000000001444410000000010011111001111111111000111111111111111111144444444
444441000000000144100000000001444410000000010000100001000000000000000000000144444444444444444
444441111110000144100000011111444411110000010000100001000000000000000000000144444444444444444
444444444410000144100000014444444444410000010000100001000000001000100000000144444444444444444
444444444410000144100000014444444444410000010000100001000000001000100000000144444444444444444
444444444411111144111111114444444444411111111111111111000000001000100000000144444444444444444
444444444444444444444444444444444444444444444444444441000000001000100000000144444444444444444
444444444444444444444444444444444444444444444444444441000000001000100000000144444444444444444
444444444444444444444444444444444444444444444444444441000000000000000000000144444444444444444
444444444444444444444444444444444444444444444444444441000000000000000000000144444444444444444
444444444444444444444444444444444444444444444444444441111111111000111111111144444444444444444
444444444444444444444444444444444444444444444444444441000000000000000000000144444444444444444
444444444444444444444444444444444444444444444444444441000000000000000000000144444444444444444
444444444444444444444444444444444444444444444444444441000000001000100000000144444444444444444
444444444444444444444444444444444444444444444444444441000000001000100000000144444444444444444
444444444444444444444444444444444444444444444444444441000000001000100000000144444444444444444
444444444444444444444444444444444444444444444444444441000000001000100000000144444444444444444
444444444444444444444444444444444444444444444444444441000000001000100000000144444444444444444
444444444444444444444444444444444444444444444444444441000000000000000000000144444444444444444
444444444444444444444444444444444444444444444444444441000000000000000000000144444444444444444
444444444444444444444444444444444444444444444444444441111111111000111111111144444444444444444
444444444444444444444444444444444444444444444444444441000000000000000000000144444444444444444
444444444444444444444444444444444444444444444444444441000000000000000000000144444444444444444
444444444444444444444444444444444444444444444444444441000000001000100000000144444444444444444
444444444444444444444444444444444444444444444444444441000000001000100000000144444444444444444
444444444444444444444444444444444444444444444444444441000000001000100000000144444444444444444
444444444444444444444444444444444444444444444444444441000000001000100000000144444444444444444
444444444444444444444444444444444444444444444444444441000000001000100000000144444444444444444
444444444444444444444444444444444444444444444444444441000000000000000000000144444444444444444
444444444444444444444444444444444444444444444444444441000000000000000000000144444444444444444
444444444444444444444444444444444444444444444444444441111111111222111111111144444444444444444
444444444444444444444444444444444444444444444444444444414444444444444444414444444444444444444
444444444444444444444444444444444444444444444444444444414444444444444444414444444444444444444
444444444444444444444444444444444444444444444444444444411111111111111111114444444444444444444
444444444444444444444444444444444444444444444444444444444444444444444444444444444444444444444