333333333333333333333333333333333333333333333333333333333333333333333333333333333333333333333
333333333311111111111111113333333333333333333333333311111111111111113333333333333333333333333
333333333310000001000000013333333333333333333333333310000001000000013333333333333333333333333
333311111110000001000000011111111111111111111111111110000001000000013333333333333333333333333
333310000000000001000000000010000100001000010000100000000001000000011113333333333333333333333
333310000000000001000000000010000100001000010000100000000001000000000013333333333333333333333
333310000000000001000000000010000100001000010000100000000001000000000013333333333333333333333
333310000000000001000000000010000100001000010000100000000001000000000013333333333333333333333
333310000000000001000000000010000100001000010000100000000001000000000013333333333333333333333
333310000000000001000000000010000100001000010000100000000001000000000013333333333333333333333
333310000000000001000000000010000100001000010000100000000001000000000011111111111113333333333
333310000000000001000000000010000100001000010000100000000001000000000010000000000111333333333
333310000000000001000000000010000100001000010000100000000001000000000010000000000001133333333
333310000000000001000000000010000100001000010000100000000001000000000010000000000000133333333
311110000000000001000000000010000100001000010000100000000001000000000010000000000000113333333
310010000000000001000000000010000100001000010000100000000001000000000010000000000000113333333
310011001111110011100111100111001110011100111001110011110011100111100110000000000001113333333
310000000000000000000000000000000000000000000000000000000000000000000010000000000011011333333
310000000000000000000000000000000000000000000000000000000000000000000011000000000110001133333
310000000000000000000000000000000000000000000000000000000000000000000001000000001100000113333
310000000000000000000000000000000000000000000000000000000000000000000000000000011000000011333
310000000000000000000000000000000000000000000011100001111111111000000000000100110000000001133
310000111111111000111000011111000011000000000010000000000000001100000000000111100000000000113
310000100010001000100000000000000001000000000010000000000000000110000000000011000000000000013
310000100010001000100000000000000001000000000010000000000000000000000000000001100000000000013
310000100010001000100000000000000001000000000010000000000000000000000000000000100000000000013
310000100010001000100000000001111111000000000010000000000000000000010000000000000000000000013
310000100111001111100000000001333320000000000010000000000000000000011000000000000000000000013
310000000000000000000000000001333320000000000010000000000000000000001100000000000000000000113
310000000000000000000000000001333320000000000011111110000000000000000100000000000110000001133
311100111111001111100000000001331110000000000010010010000000000000000100000000000011000011333
310000000000000133100000000001333310000011111110010011111110011111111100000000000001100113333
310000000000000133100000000001333310000010000000000000000000000000000000000000000000111133333
311111000000000133100000000001333310000010000000000000000000000000000000000000000000233333333
333331000000000133100000000001333310000010000000000000000000000000000000000000000000233333333
333331000000000133100000000001333310000000000000000000000000000000000000000000000000233333333
333331000000000133100000000001333310000000010011111001111111111000111111111111111111133333333
333331000000000133100000000001333310000000010000100001000000000000000000000133333333333333333
333331111110000133100000011111333311110000010000100001000000000000000000000133333333333333333
333333333310000133100000013333333333310000010000100001000000001000100000000133333333333333333
333333333310000133100000013333333333310000010000100001000000001000100000000133333333333333333
333333333311111133111111113333333333311111111111111111000000001000100000000133333333333333333
333333333333333333333333333333333333333333333333333331000000001000100000000133333333333333333
333333333333333333333333333333333333333333333333333331000000001000100000000133333333333333333
333333333333333333333333333333333333333333333333333331000000000000000000000133333333333333333
333333333333333333333333333333333333333333333333333331000000000000000000000133333333333333333
333333333333333333333333333333333333333333333333333331111111111000111111111133333333333333333
333333333333333333333333333333333333333333333333333331000000000000000000000133333333333333333
333333333333333333333333333333333333333333333333333331000000000000000000000133333333333333333
333333333333333333333333333333333333333333333333333331000000001000100000000133333333333333333
333333333333333333333333333333333333333333333333333331000000001000100000000133333333333333333
333333333333333333333333333333333333333333333333333331000000001000100000000133333333333333333
333333333333333333333333333333333333333333333333333331000000001000100000000133333333333333333
333333333333333333333333333333333333333333333333333331000000001000100000000133333333333333333
333333333333333333333333333333333333333333333333333331000000000000000000000133333333333333333
333333333333333333333333333333333333333333333333333331000000000000000000000133333333333333333
333333333333333333333333333333333333333333333333333331111111111000111111111133333333333333333
333333333333333333333333333333333333333333333333333331000000000000000000000133333333333333333
333333333333333333333333333333333333333333333333333331000000000000000000000133333333333333333
333333333333333333333333333333333333333333333333333331000000001000100000000133333333333333333
333333333333333333333333333333333333333333333333333331000000001000100000000133333333333333333
333333333333333333333333333333333333333333333333333331000000001000100000000133333333333333333
333333333333333333333333333333333333333333333333333331000000001000100000000133333333333333333
333333333333333333333333333333333333333333333333333331000000001000100000000133333333333333333
333333333333333333333333333333333333333333333333333331000000000000000000000133333333333333333
333333333333333333333333333333333333333333333333333331000000000000000000000133333333333333333
333333333333333333333333333333333333333333333333333331111111111222111111111133333333333333333
333333333333333333333333333333333333333333333333333333313333333333333333313333333333333333333
333333333333333333333333333333333333333333333333333333313333333333333333313333333333333333333
333333333333333333333333333333333333333333333333333333311111111111111111113333333333333333333
333333333333333333333333333333333333333333333333333333333333333333333333333333333333333333333