8888888888888888888888888888888888888888888888888888888888888888888888888888888888888888
8111111111111111112221111122111221111111111111111111122111221111112221111111111111111118
8100000000000000000000000000000000000000000000000000000000000000000000000000000001000818
8100000000000000000000000000000000000000000000000000000000000000000000000000000001008818
8100000000000000000000000000000000000000000000000000000000000000000000000000000081000818
8100000000000000000000000000000000000000000000000000000000000000000000000000180081008818
8100000000000000000000000000000000000000000000000000000000000000000000001000111111000818
8100000000000000000000000000000000000000000000000000000000000000000000001000180000008818
8100000000000000000000000000000000000000000000000000000000000000000000001000100800000818
8100000000000000000000000000000000000000000000000000000000000000000000001000188800008818
8100000000000000000000000000000000000000000000000000000000000000000000001000100000000018
8100000000000000000000000000000000000000000000000000000000000000000000001000000000000018
8100000000000000000000000000000000000000000000000000000000000000000000001000000888088818
8100000000000000000000000000000000000000000000000000000000000000000000001000111111111118
8100000000000000000000000000000000000000000000000000000000000000000000001000000888088818
8100000000000000000000000000000000000000000000000000000000000000000000001000000000000018
8100000000000000000000000000000000000000000000000000000000000000000000001000188800000018
8100000000000000000000000000000000000000000000000000000000000000000000001000100800000018
8100000000000000000000000000000000000000000000000000000000000000000000001000180000000018
8100000000000000000000000000000000000000000000000000000000000000000000001000188800000018
8100000000000000000000000000000000000000000000000000000000000000000000001000100800000018
8100000000000000000000000000000000000000000000000000000000000000000000001000180000000018
8100000000000000000000000000000000000000000000000000000000000000000000000000188800000018
8100000000000000000000000000000000000000000000000000000000000000000000000000100800000018
8100000000000000000000000000000000000000000000000000000000000000000000000000180000000018
8100000000000000000000000000000000000000000000000000000000000000000000000000111111111118
8100000000000000000000000000000000000000000000000000000000000000000000000000000000000018
8100000000000000000000000000000000000000000000000000000000000000000000000000000000000018
8100000000000000000000000000000000000808080808080808080800000000000000000000000000000018
8100000000000000000000000000000000000808080808080808080800000000000000000000000000000018
8100000000000000000000000000000000000808080808080808080800000000000000000000000000000018
8100000000000000000000000000000000000808080808080808080800000000000000000000000000000018
8100000000000000000000000000000000000808080808080808080800000000000000000000000000000018
8100000000000000000000000000000000000808080808080808080800000000000000000000000000000018
8100000000001000000000000000000000000000000000000000000000000000000000000000000000000018
8100000000001000000000000000000000000000000000000000000000000000000000000000000000000018
8100000000001000000000000000000000000000000000000000000000000000000000000000000000000018
8100000000001000000000000000000000000000000000000000000000000000000000000000000000000018
8100000000001000000000000000000000000000000000000000000000000000000000000000000000000018
8100000000001000000000000000000000000000000000000000000000000000000000000000000000000018
8100000000001000000000000000000000000808080808080808080800000000000000000000000000100018
8100000000001000000000000000000000000808080808080808080800000000000000000000000000100018
8100000000001000000000000000000000000808080808080808080800000000000000000000000000100018
8100000000001000000000000000000000000808080808080808080800000000000000000000000000100018
8100000000001000000000000000000000000808080808080808080800000000000000000000000000100018
8100000000001000000000000000000000000808080808080808080800000000000000000000000000100028
8100000000001000000000000000000000000000000000000000000000000000000000000000000000100028
8100000000001000000000000000000000000000000000000000000000000000000000000000000000100028
8100000000001000000000000000000000000000000000000000000000000000000000000000111111100018
8100000000001000000000000000000000000000000000000000000000000000000000000000100000000018
8100000000001000000000000000000000000000000000000000000000000000000000000000100000000018
8100000000000000000000000000000000000000000000000000000000000000000000000000100000000018
8100000000000000000000000000000000000000000000000000000000000000000000000000100000000018
8100000000000000000000000000000000000000000000000000000000000000000000000000100011111118
8100000000000000000000000000000000000000000000000000000000000000000000000000100000000018
8100000000000000000000000000000000000000000000000000000000000000000000000000100000000018
8100000000000000000000000000000000000000000000000000000000000000000000000000100018808018
8100000000000000000000000000000000000000000000000000000000000000000000000000111111111118
8100000000000000000000000000000000000000000000000000000000000000000000000000100000000018
8100000000000000000000000000000000000000000000000000000000000000000000000000100000000018
8100000000000000000000000000000000000000000000000000000000000000000000000000100018808018
8100000000000000000000000000000000000000000000000000000000000000000000000000100011111118
8100000000000000000000000000000000000000000000000000000000000000000000000000100018808018
8100000000000000000000000000000000000000000000000000000000000000000000000000100000000018
8100000000000000000000000000000000000000000000000000000000000000000000000000100000000018
8100000000000000000000000000000000000000000000000000000000111111111111111111100011111118
8100000000000000000000000000000000000000000000000000000000100000000000000000000088888818
8100000000000000000111111111111111111111111111111111100000100000000000000000000000000018
8100000000000000000100000000000000000000010000000100000000100000000000000000000000000028
8100000000000000000100000000000000000000010000000100000000100000000000000000000000000028
8100000000000000000100000000000000000000000000000000011111100000000000000000000000000028
8100000000000000000100000000000000000000000000000000000000000000000000000000000000000818
8100000000000000000100000000000000000000000000000000000000000000000000000000000000000818
8100000000000000000100000000000000000000000000000000000000000000000000000000000000000818
8100000000000000000188888888888888888888888888888800000000000000088888888888888888888818
8111111111111222111111111111111111111111111111111111111111111111111111111111111111111118
8888888888888888888888888888888888888888888888888888888888888888888888888888888888888888