3333333333333333333333333333333333333333333333333333333333333333333333333333333333333333
3111111111111111112221111122111221111111111111111111122111221111112221111111111111111113
3100000000000000000000000000000000000000000000000000000000000000000000000000000001000313
3100000000000000000000000000000000000000000000000000000000000000000000000000000001003313
3100000000000000000000000000000000000000000000000000000000000000000000000000000031000313
3100000000000000000000000000000000000000000000000000000000000000000000000000130031003313
3100000000000000000000000000000000000000000000000000000000000000000000001000111111000313
3100000000000000000000000000000000000000000000000000000000000000000000001000130000003313
3100000000000000000000000000000000000000000000000000000000000000000000001000100300000313
3100000000000000000000000000000000000000000000000000000000000000000000001000133300003313
3100000000000000000000000000000000000000000000000000000000000000000000001000100000000013
3100000000000000000000000000000000000000000000000000000000000000000000001000000000000013
3100000000000000000000000000000000000000000000000000000000000000000000001000000333033313
3100000000000000000000000000000000000000000000000000000000000000000000001000111111111113
3100000000000000000000000000000000000000000000000000000000000000000000001000000333033313
3100000000000000000000000000000000000000000000000000000000000000000000001000000000000013
3100000000000000000000000000000000000000000000000000000000000000000000001000133300000013
3100000000000000000000000000000000000000000000000000000000000000000000001000100300000013
3100000000000000000000000000000000000000000000000000000000000000000000001000130000000013
3100000000000000000000000000000000000000000000000000000000000000000000001000133300000013
3100000000000000000000000000000000000000000000000000000000000000000000001000100300000013
3100000000000000000000000000000000000000000000000000000000000000000000001000130000000013
3100000000000000000000000000000000000000000000000000000000000000000000000000133300000013
3100000000000000000000000000000000000000000000000000000000000000000000000000100300000013
3100000000000000000000000000000000000000000000000000000000000000000000000000130000000013
3100000000000000000000000000000000000000000000000000000000000000000000000000111111111113
3100000000000000000000000000000000000000000000000000000000000000000000000000000000000013
3100000000000000000000000000000000000000000000000000000000000000000000000000000000000013
3100000000000000000000000000000000000303030303030303030300000000000000000000000000000013
3100000000000000000000000000000000000303030303030303030300000000000000000000000000000013
3100000000000000000000000000000000000303030303030303030300000000000000000000000000000013
3100000000000000000000000000000000000303030303030303030300000000000000000000000000000013
3100000000000000000000000000000000000303030303030303030300000000000000000000000000000013
3100000000000000000000000000000000000303030303030303030300000000000000000000000000000013
3100000000001000000000000000000000000000000000000000000000000000000000000000000000000013
3100000000001000000000000000000000000000000000000000000000000000000000000000000000000013
3100000000001000000000000000000000000000000000000000000000000000000000000000000000000013
3100000000001000000000000000000000000000000000000000000000000000000000000000000000000013
3100000000001000000000000000000000000000000000000000000000000000000000000000000000000013
3100000000001000000000000000000000000000000000000000000000000000000000000000000000000013
3100000000001000000000000000000000000303030303030303030300000000000000000000000000100013
3100000000001000000000000000000000000303030303030303030300000000000000000000000000100013
3100000000001000000000000000000000000303030303030303030300000000000000000000000000100013
3100000000001000000000000000000000000303030303030303030300000000000000000000000000100013
3100000000001000000000000000000000000303030303030303030300000000000000000000000000100013
3100000000001000000000000000000000000303030303030303030300000000000000000000000000100023
3100000000001000000000000000000000000000000000000000000000000000000000000000000000100023
3100000000001000000000000000000000000000000000000000000000000000000000000000000000100023
3100000000001000000000000000000000000000000000000000000000000000000000000000111111100013
3100000000001000000000000000000000000000000000000000000000000000000000000000100000000013
3100000000001000000000000000000000000000000000000000000000000000000000000000100000000013
3100000000000000000000000000000000000000000000000000000000000000000000000000100000000013
3100000000000000000000000000000000000000000000000000000000000000000000000000100000000013
3100000000000000000000000000000000000000000000000000000000000000000000000000100011111113
3100000000000000000000000000000000000000000000000000000000000000000000000000100000000013
3100000000000000000000000000000000000000000000000000000000000000000000000000100000000013
3100000000000000000000000000000000000000000000000000000000000000000000000000100013303013
3100000000000000000000000000000000000000000000000000000000000000000000000000111111111113
3100000000000000000000000000000000000000000000000000000000000000000000000000100000000013
3100000000000000000000000000000000000000000000000000000000000000000000000000100000000013
3100000000000000000000000000000000000000000000000000000000000000000000000000100013303013
3100000000000000000000000000000000000000000000000000000000000000000000000000100011111113
3100000000000000000000000000000000000000000000000000000000000000000000000000100013303013
3100000000000000000000000000000000000000000000000000000000000000000000000000100000000013
3100000000000000000000000000000000000000000000000000000000000000000000000000100000000013
3100000000000000000000000000000000000000000000000000000000111111111111111111100011111113
3100000000000000000000000000000000000000000000000000000000100000000000000000000033333313
3100000000000000000111111111111111111111111111111111100000100000000000000000000000000013
3100000000000000000100000000000000000000010000000100000000100000000000000000000000000023
3100000000000000000100000000000000000000010000000100000000100000000000000000000000000023
3100000000000000000100000000000000000000000000000000011111100000000000000000000000000023
3100000000000000000100000000000000000000000000000000000000000000000000000000000000000313
3100000000000000000100000000000000000000000000000000000000000000000000000000000000000313
3100000000000000000100000000000000000000000000000000000000000000000000000000000000000313
3100000000000000000133333333333333333333333333333300000000000000033333333333333333333313
3111111111111222111111111111111111111111111111111111111111111111111111111111111111111113
3333333333333333333333333333333333333333333333333333333333333333333333333333333333333333