11111111111111111222111112211122111111111111111111112211122111111222111111111111111111
19999999999900000000000000000000000000000000000000000000000000000000000000000000100081
19999999999900000000000000000000000000000000000000000000000000000000000000000000100881
19999999999900000000000000000000000000000000000000000000000000000000000000000008100081
19999999999900000000000000000000000000000000000000000000000000000000000000018008100881
19999999999900000000000000000000000000000000000000000000000000000000000100011111100081
19999999999990000000000000000000000000000000000000000000000000000000000100018000000881
19999999999990000000000000000000000000000000000000000000000000000000000100010080000081
19999999999990000000000000000000000000000000000000000000000000000000000100018880000881
19999999999990000000000000000000000000000000000000000000000000000000000100010000000001
19999999999990000000000000000000000000000000000000000000000000000000000100000000000001
19999999999990000000000000000000000000000000000000000000000000000000000100000088808881
19999999999990000000000000000000000000000000000000000000000000000000000100011111111111
19999999999990000000000000000000000000000000000000000000000000000000000100000088808881
19999999999990000000000000000000000000000000000000000000000000000000000100000000000001
19999999999990000000000000000000000000000000000000000000000000000000000100018880000001
19999999999990000000000000000000000000000000000000000000000000000000000100010080000001
19999999999990000000000000000000000000000000000000000000000000000000000100018000000001
10009999999990000000000000000000000000000000000000000000000000000000000100018880000001
10000000000000000000000000000000000000000000000000000000000000000000000100010080000001
10000000000000000000000000000000000000000000000000000000000000000000000100018000000001
10000000000000000000000000000000000000000000000000000000000000000000000000018880000001
10000000000000000000000000000000000000000000000000000000000000000000000000010080000001
10000000000000000000000000000000000000000000000000000000000000000000000000018000000001
10000000000000000000000000000000000000000000000000000000000000000000000000011111111111
10000000000000000000000000000000000000000000000000000000000000000000999999999999999991
10000000000000000000000000000000000000000000000000000000000000000009999999999999999991
10000000000000000000000000000000000080808080808080808080000000000099999999999999999991
10000000000000000000000000000000000080808080808080808080000000000099999999999999999991
10000000000000000000000000000000000080808080808080808080000000000999999999999999999991
10000000000000000000000000000000000080808080808080808080000000000999999999999999999991
10000000000000000000000000000000000080808080808080808080000000009999999999999999999991
10000000000000000000000000000000000080808080808080808080000000009999999999999999999991
10000000000100000000000000000000000000000000000000000000000000099999999999999999999991
10000000000100000000000000000000000000000000000000000000000000099999999999999999999991
10000000000100000000000000000000000000000000000000000000000000099999999999999999999991
10000000000100000000000000000000000000000000000000000000000000099999999999999999999991
10000000000100000000000000000000000000000000000000000000000000099999999999999999999991
10000000000100000000000000000000000000000000000000000000000000099999999999999999999991
10000000000100000000000000000000000080808080808080808080000000009999999999999999919991
10000000000100000000000000000000000080808080808080808080000000009999999999999999910001
10000000000100000000000000000000000080808080808080808080000000000999999999999999910001
10000000000100000000000000000000000080808080808080808080000000000999999999999999910001
10000000000100000000000000000000000080808080808080808080000000000099999999999999910001
10000000000100000000000000000000000080808080808080808080000000000099999999999999910002
10000000000100000000000000000000000000000000000000000000000000000009999999999999910002
10000000000100000000000000000000000000000000000000000000000000000000999999999999910002
10000000000100000000000000000000000000000000000000000000000000000000000099911111110001
10000000000100000000000000000000000000000000000000000000000000000000000099910000000001
10000000000100000000000000000000000000000000000000000000000000000000000099910000000001
10000000000000000000000000000000000000000000000000000000000000000000000099910000000001
10000000000000000000000000000000000000000000000000000000000000000000000099910000000001
10000000000000000000000000000000000000000000000000000000000000000000000099910001111111
10000000000000000000000000000000000000000000000000000000000000000000000099910000000001
10000000000000000000000000000000000000000000000000000000000000000000000099910000000001
10000000000000000000000000000000000000000000000000000000000000000000000099910001880801
10000000000000000000000000000000000000000000000000000000000000000000000099911111111111
10000000000000000000000000000000000000000000000000000000000000000000000099910000000001
10000000000000000000000000000000000000000000000000000000000000000000000099910000000001
10000000000000000000000000000000000000000000000000000000000000000000000099910001880801
10000000000000000000000000000000000000000000000000000000000000000000000099910001111111
10000000000000000000000000000000000000000000000000000000000009999999999999910001880801
10009999999000000000000000000000000000000000000000000000000009999999999999910000000001
19999999999000000000000000000000000000000000000000000000000009999999999999910000000001
19999999999000000000000000000000000000000000000000000000011111111111111111110001111111
19999999999000000000000000000000000000000000000000000000010000000000000000000008888881
19999999999000000011111111111111111111111111111111110000010000000000000000000000000001
19999999999000000010000000000000000000001000000010000000010000000000000000000000000002
19999999999000000010000000000000000000001000000010000000010000000000000000000000000002
19999999999000000010000000000000000000000000000000001111110000000000000000000000000002
19999999999000000010000000000000000000000000000000000000000000000000000000000000000081
19999999999000000010000000000000000000000000000000000000000000000000000000000000000081
19999999999000000010000000000000000000000000000000000000000000000000000000000000000081
19999999999000000018888888888888888888888888888880000000000000008888888888888888888881
11111111111122211111111111111111111111111111111111111111111111111111111111111111111111
